#####################################################################################
#   #########################################################       ########        #
# >              ##########       ######   ##################       ########        #
#   #######           #####                ###                              ##      #
###########      #### #####       ### ##   ###    ###########       #######         # 
###########      ####             ### ##          ##########################        #
###########      #######################   ###    ##########################        #
###########################       ### ########    #######               ###         #
##                         # #### ### #### ##############        ######             #
## #######################   ####                         # ###############         #
##          ################################################################        #
##          #                                    #                                  #
##          #                                    #                                  #
##          ######################################    ######################        #
########### ##########    ## ####       ## ######                  ########         #
########### ##########       #### ##    ## ######      #### #      ########         #
########### ################ #### ##    ## ######      #### #      ########         #
########      ############## #### ##    ## ################ #      ########         #
########                     #### ##    ## ################ #      ########         #
####   #      ################### #######                   #      ########         #
####   ### #######           #### ####### ###################      ########         #
###### ### ####### #########      ####### ##      ###########      ########         #
######     ####### ##############       # ##      ################################# #  
##########             ################           #############    @                #
#####################################################################################
