################################################################################
#   ############################################################       #########
# > #######      ##########       #########   ##################       #########
#   #######           #####           #####   ###                              #
## ########      #### #####       ### #####   ###    ###########       ####### #
## ########      ####             ### #####   ###    ######################### #
## ########      ##########       ### #####   ###    ######################### #
## ########################       ### ####### ###    #######               ### #
## ######################### ######## ####### ##############        ######     #
## ######################### ####     ####### ################ ############### #
##          ################ #### ########### ################ ############### #
########### ##########    ## #### ########### ######           #    @ ######## #
########### ##########    ## #### ########### ###### ######### #      ######## #
########### ##########    ## ####          ## ######      #### #      ######## #
########### ##########       #### ##       ## ######      #### #      ######## #
########### ################ #### ##       ## ######      #### #      ######## #
########      ############## #### ##       ## ################ #      ######## #
########                     #### ##       ## ################ #      ######## #
####   #      ################### ##########                   #      ######## #
####   ### #######           #### ########## ###################      ######## #
###### ### ####### #########      ########## ##      ###########      ######## #
######     ####### ##############          # ##      ############# ########### #
#################      ###################           ############# ########### #
#################      ###########################################             #
################################################################################
