#############################################################################
#   #########################################################       #########
# >              ##########       ######   ##################       #########
#   #######           #####                ###                              ##
###########      #### #####       ### ##   ###    ###########       #######  #
###########      ####             ### ##          ########################## #
###########      #######################   ###    ########################## #
###########################       ### ########    #######               ###  #
##                         # #### ### #### ##############        ######     #
## #######################   ####                         # ############### #
##          ###################################    ##########################
##          #                                 ######
##          #
##          #################################################################
########### ##########    ## ####       ## ######                  ######## #
########### ##########       #### ##    ## ######      #### #      ######## #
########### ################ #### ##    ## ######      #### #      ######## #
########      ############## #### ##    ## ################ #      ######## #
########                     #### ##    ## ################ #      ######## #
####   #      ################### #######                   #      ######## #
####   ### #######           #### ####### ###################      ######## #
###### ### ####### #########      ####### ##      ###########      ######## #
######     ####### ##############       # ##      ############# ########### #
##########             ################           #############    @        #
#############################################################################
